13 18
E00E01E02E03               T19E20C21L22
P67      B04               E18      E23
E66      E05               N17      P24
T65      E06               T16      E25
C64      E07               E15      V26
E63      E08V09E10E11E12E13L14      T27
L62                              E29N28
E61                              L30,,,
B60                              E31,,,
E59N58L57T56E55                  E32,,,
            E54                  E33,,,
            E53                  E34,,,
            E52E51B50            E35,,,
                  E49      E38T37E36,,,
                  E48      E39,,,,,,,,,
                  E47      V40,,,,,,,,,
                  E46E45   E41,,,,,,,,,
                     C44T43B42,,,,,,,,,