18 13
E00E01E02E03               T19H20C21L22E23P24E25V26T27
P67      B04               E18                     N28
E66      E05               N17                     E29
T65      E06               T16                  E31L30
C64      E07               E15                  E32,,,
E63      E08V09E10E11E12E13L14                  E33,,,
L62                                             E34,,,
E61                                             E35,,,
B60E59                                    E38T37E36,,,
      N58                                 E39,,,,,,,,,
         L57      E52E51B50E49            V40,,,,,,,,,
            T56   E53      E48            E41,,,,,,,,,
               E55E54      E47E46E45C44T43B42,,,,,,,,,




